########
#   .  #
#  BB  #
#   #  #
#  .  P#
########